VPFFFFFFFPFFF
FPFFFFFFFPFFF
FPPPPPPPPPFFF
FPFFFVVVVVVFF
FPFFFFFFFFFFF
FPPFFFFPFFFPF
